25 19
12 3
0 0 6 6 6 6 6 6 0 0 0 3 0 0 0 0 0 0 0 0 0 0 0 0 0
0 0 6 6 6 6 6 6 0 0 0 3 0 0 0 0 0 0 0 0 0 0 0 0 0
0 0 6 6 6 6 6 6 0 0 0 3 0 0 0 0 0 0 0 0 0 0 0 0 0 
0 0 6 6 6 6 6 6 0 0 0 3 0 1 1 1 1 1 1 1 1 1 0 0 0
0 0 6 6 6 6 6 6 0 0 0 3 0 1 2 2 2 2 2 2 2 1 0 0 0
0 0 6 6 6 6 6 6 0 0 0 3 0 1 2 2 2 2 2 2 2 1 0 0 0 
0 0 6 6 6 6 6 6 0 0 0 3 0 1 2 2 2 2 2 2 2 1 0 0 0
0 0 6 6 6 6 6 6 0 0 0 3 0 1 1 1 1 3 1 1 1 1 0 0 0
0 0 6 6 6 6 6 6 0 0 0 3 3 3 3 3 3 3 3 3 3 3 3 3 3 
0 0 6 6 6 6 6 6 0 0 0 3 0 0 0 0 0 0 0 0 0 0 0 0 0
0 0 6 6 6 6 6 6 0 0 0 3 0 0 0 1 1 1 1 1 1 0 0 0 0
0 0 6 6 6 6 6 6 0 0 0 3 0 0 0 1 5 5 5 5 1 0 0 0 0 
0 0 6 6 6 6 6 6 0 0 0 3 0 0 0 1 5 5 5 5 1 0 0 0 0
0 0 6 6 6 6 6 6 0 0 0 3 3 3 3 3 5 5 5 5 1 0 0 0 0
0 0 6 6 6 6 6 6 0 0 0 3 0 0 0 1 5 5 5 5 1 0 0 0 0 
0 0 6 6 6 6 6 6 0 0 0 3 0 0 0 1 5 5 5 5 1 0 0 0 0
0 0 6 6 6 6 6 6 0 0 0 3 0 0 0 1 1 1 1 1 1 0 0 0 0
0 0 6 6 6 6 6 6 0 0 0 3 0 0 0 0 0 0 0 0 0 0 0 0 0 
0 0 6 6 6 6 6 6 0 0 0 3 0 0 0 0 0 0 0 0 0 0 0 0 0 